#grafika kafelek
kafelki.jpg

#rozmiar mapy w kafelkach [x, y]
40 40

#rozmiar kafelka [x, y]
48 48

#mapa
 18 15 18 18 4 4 15 15 15 15 18 15 4 4 18 4 15 4 4 15 18 4 18 15 15 4 4 15 15 4 18 18 4 18 18 4 15 4 15 18
 15 15 4 15 15 15 15 4 18 15 15 4 18 15 15 15 15 4 18 18 15 18 18 4 18 15 18 18 15 18 4 15 4 4 18 18 15 15 4 18
 15 18 15 15 4 18 18 15 4 18 18 15 4 4 4 4 15 4 15 4 18 15 15 15 18 15 4 18 15 15 4 4 4 15 18 15 4 15 18 18
 15 18 18 18 18 18 15 18 15 15 15 4 15 15 18 18 4 4 15 4 4 18 18 4 18 15 4 4 15 15 4 4 18 4 18 15 4 4 4 18
 15 18 15 15 4 18 15 4 15 15 15 18 15 18 15 18 18 4 15 18 18 4 18 18 18 4 15 15 18 15 15 18 4 18 15 18 18 15 15 4
 15 18 18 18 15 15 18 4 4 4 18 18 18 4 18 18 18 4 4 18 18 15 15 15 18 15 4 15 18 4 15 15 18 15 18 18 15 18 15 4
 4 4 15 4 4 4 15 15 15 4 4 4 4 15 18 18 15 4 4 18 18 18 18 4 4 15 15 4 18 18 18 18 4 18 15 4 18 4 4 18
 4 4 4 4 4 15 15 4 15 4 15 18 18 4 4 18 4 18 15 15 18 18 15 18 18 18 4 15 15 18 15 18 18 4 18 18 15 18 4 15
 18 4 18 4 15 4 4 4 15 15 4 4 15 4 18 15 15 4 4 4 4 15 15 15 4 15 15 4 15 18 15 18 15 4 18 18 15 15 18 4
 15 4 18 4 18 15 15 15 4 18 18 18 15 15 18 4 15 18 18 4 15 15 4 15 18 4 4 15 15 18 15 18 18 15 18 15 15 15 4 15
 18 4 15 4 4 18 15 15 15 4 15 4 18 18 4 18 4 18 15 18 15 4 18 15 15 18 18 4 15 18 15 15 15 4 18 18 15 18 18 4
 18 15 18 15 18 18 18 4 4 15 4 18 15 15 4 18 4 15 4 18 18 18 4 15 15 15 15 15 15 18 15 15 4 18 18 18 15 4 4 15
 4 15 4 4 4 15 4 4 15 15 4 18 4 18 4 4 15 4 4 4 4 15 4 18 18 4 4 4 15 4 4 15 4 18 4 4 18 18 4 4
 15 15 18 18 4 4 4 15 18 4 4 15 15 15 4 15 15 18 15 4 15 15 18 18 4 4 4 18 4 4 4 18 15 18 18 15 4 18 18 15
 15 4 15 15 4 18 4 18 18 15 18 4 4 4 4 18 15 4 18 18 4 15 18 4 4 15 18 4 4 4 4 4 15 4 18 15 15 18 15 18
 4 18 18 15 4 4 15 18 15 4 18 4 15 15 4 4 4 18 18 18 15 15 4 18 4 4 4 15 18 18 18 18 18 4 4 15 4 18 4 4
 4 4 15 4 15 4 18 15 15 15 18 4 18 4 18 15 18 15 18 15 15 4 15 18 18 4 18 4 18 15 4 4 4 18 15 4 15 15 18 18
 15 15 15 18 15 15 15 15 4 18 4 15 15 18 15 18 18 18 18 4 15 4 4 15 15 15 4 18 15 15 18 4 4 18 15 15 18 4 15 4
 4 4 4 15 4 15 4 15 18 15 4 15 15 4 4 18 15 18 4 4 18 15 15 4 18 4 18 18 18 15 15 18 4 15 15 18 4 4 4 15
 15 18 18 4 4 15 4 4 15 4 15 18 18 18 4 4 4 15 15 4 18 4 4 15 18 4 18 18 15 4 4 4 15 15 18 15 4 15 15 15
 18 4 15 15 18 15 18 18 18 15 15 4 4 4 15 4 4 18 15 18 4 4 15 18 18 4 18 15 4 4 4 15 18 18 15 4 4 4 15 18
 18 15 18 15 18 18 15 4 4 15 4 18 4 4 18 15 18 18 18 15 15 15 4 15 4 18 4 4 4 4 15 15 18 15 4 4 4 18 18 4
 4 4 18 4 18 18 18 4 15 15 18 15 15 15 18 15 18 4 4 18 18 4 18 18 18 4 4 4 4 4 15 15 15 15 18 4 18 15 15 15
 15 4 15 15 4 4 15 18 18 18 4 15 18 18 4 4 15 15 4 15 4 4 4 18 18 18 15 18 18 15 15 4 15 4 4 18 4 18 15 18
 15 18 4 15 15 18 4 18 4 4 15 18 18 18 4 18 18 4 18 18 15 15 18 18 15 18 4 15 18 18 4 4 18 4 4 18 15 15 18 15
 15 4 18 15 4 4 15 18 18 15 15 18 4 15 15 18 15 15 15 15 4 4 15 18 4 18 15 4 18 18 15 4 15 18 18 15 4 18 15 15
 4 4 4 18 15 18 15 15 18 18 18 15 15 18 18 4 4 15 18 4 4 4 4 18 4 4 4 18 18 15 18 18 4 4 18 18 18 15 4 4
 18 18 18 18 15 18 15 15 15 4 18 18 15 18 4 15 15 15 15 15 15 4 18 15 15 15 18 18 18 4 18 4 15 4 4 18 18 15 15 4
 18 15 18 18 18 4 18 15 15 15 4 18 4 15 15 4 15 18 15 4 4 18 15 4 15 15 15 15 18 4 18 15 4 4 18 18 15 18 4 18
 4 18 4 4 4 4 18 4 15 18 18 4 15 15 18 18 4 4 15 15 18 4 15 4 15 18 4 18 4 18 15 18 18 15 18 18 15 4 15 15
 18 4 15 18 18 15 4 15 15 4 18 15 15 18 15 18 18 4 18 4 18 15 15 15 15 15 18 15 4 18 15 18 15 18 15 18 18 18 4 15
 4 4 15 15 15 4 4 4 18 15 15 15 18 15 18 18 4 4 15 18 4 15 15 18 18 15 4 4 18 15 4 18 4 4 15 18 4 4 18 18
 15 15 15 18 15 15 18 15 18 18 4 15 15 18 4 15 4 4 15 4 4 18 15 18 18 18 4 4 15 18 15 18 4 18 18 15 15 15 15 18
 18 4 4 15 15 18 4 4 18 15 18 18 18 4 15 15 18 15 15 4 18 18 15 18 18 15 4 4 4 4 4 15 15 18 18 15 18 18 4 4
 18 15 15 18 18 4 18 15 18 18 4 18 15 4 18 15 4 18 18 4 4 15 18 15 18 4 4 18 4 15 18 15 15 18 4 15 15 15 18 15
 4 15 4 18 4 15 15 15 18 4 18 18 4 18 18 18 18 18 18 15 18 4 15 4 15 15 18 18 4 15 18 18 18 18 15 4 15 4 15 15
 15 4 18 4 4 18 4 4 15 15 18 18 15 4 4 18 4 4 15 4 15 18 4 15 15 18 18 15 15 4 18 18 18 15 18 15 4 4 18 18
 18 15 18 4 18 18 18 18 18 15 18 15 4 18 4 4 18 15 15 4 4 4 4 4 15 18 4 18 4 4 18 15 15 15 15 18 18 18 4 18
 18 4 4 4 18 18 15 15 4 15 18 15 15 18 15 18 4 18 4 18 4 15 15 4 15 4 18 4 18 4 4 4 4 4 18 4 15 15 18 18
 4 4 15 4 18 15 4 15 18 4 4 4 4 18 4 18 18 15 15 4 18 18 4 15 4 15 15 4 18 15 15 18 4 4 18 18 15 15 4 15
