#grafika kafelek
kafelki.jpg

#rozmiar mapy w kafelkach[x, y]
20 20

#rozmiar kafelka[x, y]
48 48

#mapa
 45 36 36 27 27 9 9 45 27 36 18 36 36 45 18 54 9 36 36 27
 27 0 27 0 36 54 36 36 27 54 36 27 27 9 18 54 18 27 27 0
 54 18 9 0 9 18 9 27 0 0 54 54 18 9 18 45 9 9 36 27
 27 54 0 36 36 9 45 9 0 27 36 9 54 27 18 0 18 27 54 9
 0 54 18 9 9 45 36 18 54 9 54 36 27 45 0 18 18 0 9 0
 9 18 36 45 36 36 54 45 0 45 9 36 27 0 36 18 0 45 45 9
 18 45 27 36 45 36 9 27 0 27 18 36 18 45 18 18 27 54 0 18
 27 0 0 18 0 0 27 54 36 54 27 18 45 0 9 9 0 9 36 36
 36 27 54 9 9 0 45 18 0 27 0 45 27 9 54 45 27 54 9 18
 18 18 54 36 27 54 45 9 36 18 54 9 54 54 54 9 9 45 45 36
 9 27 27 45 0 0 0 45 27 54 27 45 36 0 27 18 27 36 45 54
 54 45 27 18 54 9 36 45 9 18 0 18 36 36 27 36 18 27 18 9
 18 9 27 18 27 18 54 27 27 45 54 9 18 27 9 0 36 0 0 36
 18 27 9 45 36 54 45 18 45 27 54 27 18 27 27 54 0 27 54 27
 0 54 9 36 45 18 9 0 18 54 0 27 27 36 45 45 18 36 45 18
 45 54 27 18 45 54 27 45 45 27 54 9 45 54 45 27 0 45 54 45
 36 27 36 54 9 9 0 9 54 18 36 0 9 45 54 27 0 54 45 36
 0 45 18 54 54 9 27 0 45 0 36 45 0 9 18 9 54 9 27 9
 9 27 0 18 36 9 45 9 0 0 0 9 27 0 27 0 27 36 18 0
 45 45 27 45 18 9 54 18 0 9 18 27 45 27 54 18 9 9 54 0
