#grafika kafelek
kafelki.jpg

#rozmiar mapy w kafelkach[x, y]
35 35

#rozmiar kafelka[x, y]
48 48

#mapa
 48 38 38 40 38 49 48 40 48 40 49 40 38 39 40 49 39 40 40 49 49 38 40 38 38 48 40 39 49 49 48 48 48 49 38
 38 38 39 38 48 38 40 49 48 49 38 40 40 38 40 38 39 48 38 38 49 49 40 48 38 39 39 48 48 40 48 40 40 48 40
 40 49 48 39 38 38 38 48 40 39 49 49 38 39 49 39 40 40 38 49 48 38 49 38 49 48 49 48 40 40 40 48 40 49 40
 49 48 39 39 49 39 49 38 39 49 38 49 49 38 40 39 39 39 39 38 49 39 38 40 39 38 49 39 38 48 38 40 40 48 48
 38 40 40 38 48 38 48 49 38 48 40 39 49 40 39 39 39 49 40 38 49 38 40 49 48 49 49 49 49 39 39 39 48 40 40
 48 49 48 39 39 48 48 39 38 39 48 40 39 49 39 40 39 49 40 38 49 48 38 38 49 39 40 38 38 39 49 48 38 38 48
 39 40 40 38 39 49 39 40 38 48 40 48 39 39 39 48 38 40 40 39 39 40 39 40 40 40 48 38 49 38 39 49 48 49 38
 39 39 48 49 40 38 49 40 39 49 48 39 38 48 38 39 49 49 39 38 49 40 48 39 40 49 39 48 39 49 40 39 39 48 39
 38 38 39 40 40 38 48 48 49 39 48 38 49 38 49 49 48 39 49 48 48 48 49 39 38 49 38 40 49 40 40 38 49 38 39
 40 38 38 49 48 38 40 39 40 39 48 40 49 39 38 40 49 38 40 38 38 49 40 38 39 38 40 48 38 40 40 40 49 40 38
 39 39 49 49 49 40 49 40 49 40 49 40 39 40 48 48 49 49 48 40 49 40 40 49 39 40 40 40 48 40 39 48 39 38 38
 38 49 49 38 48 49 48 38 48 39 48 38 48 48 39 39 49 39 38 48 48 48 38 40 49 48 40 38 49 38 49 39 49 49 38
 49 49 48 38 39 40 38 38 49 48 40 40 49 48 39 40 48 39 48 40 40 49 48 40 49 38 39 38 40 38 39 48 40 49 48
 48 39 49 40 39 49 38 48 48 48 49 48 40 39 40 40 49 48 38 40 39 40 38 38 40 48 48 38 48 40 48 48 48 39 49
 49 48 40 39 48 48 38 40 49 40 48 40 48 39 40 49 48 40 40 48 38 40 38 48 40 48 38 49 40 49 40 49 38 40 38
 40 48 49 40 38 39 39 39 48 49 49 49 49 38 48 48 48 40 48 38 38 49 40 39 48 48 38 39 48 49 38 49 40 49 49
 39 38 38 49 39 39 48 40 38 39 48 39 39 38 40 40 49 38 38 48 39 49 39 49 40 38 38 38 39 49 48 38 38 49 40
 48 38 49 40 38 40 38 39 49 49 40 40 38 49 49 40 49 40 40 40 39 39 49 38 48 38 48 38 38 40 49 40 48 39 39
 48 38 49 39 40 39 38 38 49 48 39 49 40 49 38 39 40 40 48 39 38 39 38 38 40 38 40 38 49 39 38 48 48 48 49
 48 39 49 39 39 38 39 48 40 38 49 39 38 48 40 48 39 48 49 39 38 38 38 49 49 40 48 49 48 48 39 48 49 39 49
 49 49 39 39 38 38 40 40 40 48 48 40 48 40 39 49 48 40 49 39 49 49 38 48 39 49 40 40 39 49 40 39 39 48 39
 40 39 38 39 39 40 39 49 39 39 40 48 49 48 48 48 48 40 40 40 39 38 40 49 48 38 40 40 48 49 49 39 48 49 38
 38 40 40 39 39 49 40 49 40 40 48 40 39 49 39 49 38 40 40 38 49 40 40 39 39 49 39 39 38 40 40 39 39 49 38
 40 39 49 48 48 40 48 48 40 40 39 40 48 38 39 39 49 48 40 48 49 40 39 48 48 49 48 40 49 40 39 39 48 40 49
 48 39 39 38 40 40 38 39 38 49 48 40 49 48 38 49 39 39 38 40 38 40 40 40 40 40 39 40 49 48 38 48 39 40 48
 48 39 49 40 38 39 39 39 40 39 38 48 48 38 49 48 49 39 49 40 39 39 39 40 48 38 38 48 38 38 39 49 39 38 38
 48 38 48 49 49 40 40 40 40 49 40 39 49 40 39 38 40 39 48 40 39 49 39 49 48 39 39 38 38 39 48 38 49 39 40
 40 39 48 49 49 40 39 40 40 49 49 49 39 38 49 48 38 38 40 49 38 38 49 40 39 40 48 38 38 39 40 39 38 40 38
 38 40 39 38 38 38 38 38 40 49 38 38 39 38 38 38 40 38 38 48 40 49 40 48 40 48 48 39 39 38 39 40 40 39 38
 39 39 38 38 49 49 40 49 38 39 49 39 48 48 38 48 40 48 39 48 38 48 48 39 38 40 40 48 49 40 40 49 49 39 38
 49 39 40 48 40 40 49 39 48 39 38 49 40 49 48 39 48 49 39 40 38 48 38 40 38 48 38 48 49 38 38 39 40 48 39
 38 49 39 39 48 39 38 48 49 38 49 39 40 38 49 48 48 48 38 40 48 48 38 48 39 48 49 48 40 39 38 49 38 40 38
 49 49 39 38 38 39 39 40 39 49 40 49 49 48 49 39 40 48 39 40 38 40 49 38 39 39 39 40 48 40 39 49 39 49 48
 40 38 48 40 40 48 38 38 48 40 48 39 38 38 49 40 49 39 39 48 48 38 49 40 40 48 40 49 39 48 39 49 48 48 48
 48 39 38 39 49 39 48 38 39 49 48 49 48 40 38 49 49 48 39 38 39 48 40 39 38 49 39 40 40 48 40 39 49 40 40
